111111
1C00P1
100001
101011
1011C1
1E0001
111111
