111111111111
1P0100100011
1001E000C001
100110111111
100000001001
111111111111
